org.apache.pdfbox.pdfparser.COSParser	org.apache.pdfbox.cos.COSStream	1
org.apache.pdfbox.rendering.PageDrawer	org.apache.pdfbox.pdmodel.graphics.image.PDImage	1
org.apache.pdfbox.pdmodel.encryption.SecurityHandler	org.apache.pdfbox.cos.COSStream	1
org.apache.pdfbox.pdmodel.font.FileSystemFontProvider	org.apache.fontbox.ttf.TrueTypeFont	1
org.apache.pdfbox.pdmodel.interactive.form.PDAcroFormFromAnnotsTest	org.apache.pdfbox.pdmodel.PDDocument	1
org.apache.pdfbox.pdmodel.interactive.digitalsignature.visible.PDFTemplateCreator	org.apache.pdfbox.pdmodel.interactive.digitalsignature.visible.PDFTemplateBuilder	1
org.apache.pdfbox.multipdf.PDFMergerUtilityTest	org.apache.pdfbox.pdmodel.PDDocument	1
org.apache.pdfbox.encryption.TestSymmetricKeyEncryption	org.apache.pdfbox.pdmodel.PDDocument	1
org.apache.pdfbox.pdmodel.interactive.form.PDAcroFormTest	org.apache.pdfbox.pdmodel.PDDocument	1
org.apache.pdfbox.contentstream.PDFStreamEngine	org.apache.pdfbox.pdmodel.font.PDType3Font	1
org.apache.pdfbox.rendering.PageDrawer	org.apache.pdfbox.pdmodel.font.PDType3Font	1
org.apache.pdfbox.cos.TestCOSStream	org.apache.pdfbox.cos.COSStream	1
org.apache.pdfbox.pdfwriter.COSWriter	org.apache.pdfbox.cos.COSStream	1
org.apache.pdfbox.pdmodel.PDAbstractContentStream	org.apache.pdfbox.pdmodel.font.PDType0Font	1
org.apache.pdfbox.pdmodel.font.PDCIDFontType2	org.apache.pdfbox.pdmodel.font.PDType0Font	1
org.apache.pdfbox.io.SequenceRandomAccessReadTest	org.apache.pdfbox.io.SequenceRandomAccessRead	1
org.apache.pdfbox.pdmodel.PDDocument	org.apache.pdfbox.cos.COSDocument	1
org.apache.pdfbox.pdmodel.interactive.form.PDXFAResource	org.apache.pdfbox.cos.COSStream	1
org.apache.pdfbox.pdfwriter.compress.COSWriterObjectStream	org.apache.pdfbox.cos.COSStream	1
org.apache.pdfbox.io.RandomAccessReadBufferTest	org.apache.pdfbox.io.RandomAccessReadBuffer	1
org.apache.pdfbox.cos.COSDocument	org.apache.pdfbox.cos.ICOSParser	1
org.apache.pdfbox.pdmodel.graphics.color.PDICCBased	org.apache.pdfbox.cos.COSStream	1
org.apache.pdfbox.pdfparser.PDFObjectStreamParser	org.apache.pdfbox.cos.COSStream	1
